Bulbizarre	フシギダネ		1
Herbizarre	フシギソウ		
Florizarre	フシギバナ		
Salamèche	ヒトカゲ		
Reptincel	リザード		
Dracaufeu	リザードン		
Carapuce	ゼニガメ		
Carabaffe	カメール		
Tortank	カメックス		
Chenipan	キャタピー		
Chrysacier	トランセル		
Papilusion	バタフリー		
Aspicot	ビードル		
Coconfort	コクーン		
Dardargnan	スピアー		
Roucool	ポッポ		
Roucoups	ピジョン		
Roucarnage	ピジョット		
Rattata	コラッタ		
Rattatac	ラッタ		
Piafabec	オニスズメ		
Rapasdepic	オニドリル		
Abo	アーボ		
Arbok	アーボック		
Pikachu	ピカチュウ		
Raichu	ライチュウ		
Sabelette	サンド		
Sablaireau	サンドパン		
Nidoran♀	ニドラン		
Nidorina	ニドリーナ		
Nidoqueen	ニドクイン		
Nidoran♂	ニドラン♂		
Nidorino	ニドリーノ		
Nidoking	ニドキング		
Mélofée	ピッピ		
Mélodelfe	ピクシー		
Goupix	ロコン		
Feunard	キュウコン		
Rondoudou	プリン		
Grodoudou	プクリン		
Nosferapti	ズバット		
Nosferalto	ゴルバット		
Mystherbe	ナゾノクサ		
Ortide	クサイハナ		
Rafflesia	ラフレシア		
Paras	パラス		
Parasect	パラセクト		
Mimitoss	コンパン		
Aéromite	モルフォン		
Taupiqueur	ディグダ		
Triopikeur	ダグトリオ		
Miaouss	ニャース		
Persian	ペルシアン		
Psykokwak	コダック		
Akwakwak	ゴルダック		
Férosinge	マンキー		
Colossinge	オコリザル		
Caninos	ガーディ		
Arcanin	ウインディ		
Ptitard	ニョロモ		
Têtarte	ニョロゾ		
Tartard	ニョロボン		
Abra	ケーシィ		
Kadabra	ユンゲラー		
Alakazam	フーディン		
Machoc	ワンリキー		
Machopeur	ゴーリキー		
Mackogneur	カイリキー		
Chétiflor	マダツボミ		
Boustiflor	ウツドン		
Empiflor	ウツボット		
Tentacool	メノクラゲ		
Tentacruel	ドククラゲ		
Racaillou	イシツブテ		
Gravalanch	ゴローン		
Grolem	ゴローニャ		
Ponyta	ポニータ		
Galopa	ギャロップ		
Ramoloss	ヤドン		
Flagadoss	ヤドラン		
Magnéti	コイル		
Magnéton	レアコイル		
Canarticho	カモネギ		
Doduo	ドードー		
Dodrio	ドードリオ		
Otaria	パウワウ		
Lamantine	ジュゴン		
Tadmorv	ベトベター		
Grotadmorv	ベトベトン		
Kokiyas	シェルダー		
Crustabri	パルシェン		
Fantominus	ゴース		
Spectrum	ゴースト		
Ectoplasma	ゲンガー		
Onix	イワーク		
Soporifik	スリープ		
Hypnomade	スリーパー		
Krabby	クラブ		
Krabboss	キングラー		
Voltorbe	ビリリダマ		
Électrode	マルマイン		
Noeunoeuf	タマタマ		
Noadkoko	ナッシー		
Osselait	カラカラ		
Ossatueur	ガラガラ		
Kicklee	サワムラー		
Tygnon	エビワラー		
Excelangue	ベロリンガ		
Smogo	ドガース		
Smogogo	マタドガス		
Rhinocorne	サイホーン		
Rhinoféros	サイドン		
Leveinard	ラッキー		
Saquedeneu	モンジャラ		
Kangourex	ガルーラ		
Hypotrempe	タッツー		
Hypocéan	シードラ		
Poissirène	トサキント		
Poissoroy	アズマオウ		
Stari	ヒトデマン		
Staross	スターミー		
M.Mime 	バリヤード		
Insécateur	ストライク		
Lippoutou	ルージュラ		
Élektek	エレブー		
Magmar	ブーバー		
Scarabrute	カイロス		
Tauros	ケンタロス		
Magicarpe	コイキング		
Léviator	ギャラドス		
Lokhlass	ラプラス		
Métamorph	メタモン	-	
Évoli	イーブイ		
Aquali	シャワーズ		
Voltali	サンダース		
Pyroli	ブースター		
Porygon	ポリゴン		
Amonita	オムナイト		
Amonistar	オムスター	—	
Kabuto	カブト		
Kabutops	カブトプス	-	
Ptéra	プテラ		
Ronflex	カビゴン		
Artikodin	フリーザー		
Électhor	サンダー		
Sulfura	ファイヤー		
Minidraco	ミニリュウ		
Draco	ハクリュー		
Dracolosse	カイリュー		
Mewtwo	ミュウツー		
Mew	ミュウ		
Germignon	チコリータ		2
Macronium	ベイリーフ		
Méganium	メガニウム		
Héricendre	ヒノアラシ		
Feurisson	マグマラシ		
Typhlosion	バクフーン	-	
Kaiminus	ワニノコ		
Crocrodil	アリゲイツ		
Aligatueur	オーダイル		
Fouinette	オタチ		
Fouinar	オオタチ	-	
Hoothoot	ホーホー		
Noarfang	ヨルノズク		
Coxy	レディバ		
Coxyclaque	レディアン		
Mimigal	イトマル		
Migalos	アリアドス		
Nostenfer	クロバット		
Loupio	チョンチー		
Lanturn	ランターン		
Pichu	ピチュー	-	
Mélo	ピィ		
Toudoudou	ププリン		
Togepi	トゲピー	-	
Togetic	トゲチック	-	
Natu	ネイティ		
Xatu	ネイティオ		
Wattouat	メリープ		
Lainergie	モココ		
Pharamp	デンリュウ		
Joliflor	キレイハナ		
Marill	マリル		
Azumarill	マリルリ		
Simularbre	ウソッキー		
Tarpaud	ニョロトノ		
Granivol	ハネッコ		
Floravol	ポポッコ		
Cotovol	ワタッコ		
Capumain	エイパム		
Tournegrin	ヒマナッツ		
Héliatronc	キマワリ		
Yanma	ヤンヤンマ		
Axoloto	ウパー		
Maraiste	ヌオー		
Mentali	エーフィ		
Noctali	ブラッキー		
Cornèbre	ヤミカラス		
Roigada	ヤドキング		
Feuforêve	ムウマ		
Zarbi	アンノーン		
Qulbutoké	ソーナンス		
Girafarig	キリンリキ		
Pomdepik	クヌギダマ		
Foretress	フォレトス		
Insolourdo	ノコッチ		
Scorplane	グライガー		
Steelix	ハガネール		
Snubbull	ブルー		
Granbull	グランブル		
Qwilfish	ハリーセン		
Cizayox	ハッサム		
Caratroc	ツボツボ		
Scarhino	ヘラクロス		
Farfuret	ニューラ		
Teddiursa	ヒメグマ		
Ursaring	リングマ		
Limagma	マグマッグ		
Volcaropod	マグカルゴ		
Marcacrin	ウリムー		
Cochignon	イノムー		
Corayon	サニーゴ		
Rémoraid	テッポウオ		
Octillery	オクタン		
Cadoizo	デリバード		
Démanta	マンタイン		
Airmure	エアームド		
Malosse	デルビル		
Démolosse	ヘルガー		
Hyporoi	キングドラ		
Phanpy	ゴマゾウ		
Donphan	ドンファン		
Porygon2	ポリゴン２		
Cerfrousse	オドシシ		
Queulorior	ドーブル		
Debugant	バルキー		
Kapoera	カポエラー	-	
Lippouti	ムチュール		
Élekid	エレキッド		
Magby	ブビィ	—	
Écrémeuh	ミルタンク		
Leuphorie	ハピナス		
Raikou	ライコウ		
Entei	エンテイ		
Suicune	スイクン		
Embrylex	ヨーギラス		
Ymphect	サナギラス		
Tyranocif	バンギラス		
Lugia	ルギア		
Ho-Oh	ホウオウ		
Celebi	セレビィ	-	
Arcko	キモリ		3
Massko	ジュプトル		
Jungko	ジュカイン		
Poussifeu	アチャモ		
Galifeu	ワカシャモ		
Braségali	バシャーモ		
Gobou	ミズゴロウ		
Flobio	ヌマクロー		
Laggron	ラグラージ		
Medhyèna	ポチエナ		
Grahyèna	グラエナ	-	
Zigzaton	ジグザグマ		
Linéon	マッスグマ		
Chenipotte	ケムッソ		
Armulys	カラサリス		
Charmillon	アゲハント		
Blindalys	マユルド	-	
Papinox	ドクケイル	-	
Nénupiot	ハスボー		
Lombre	ハスブレロ		
Ludicolo	ルンパッパ		
Grainipiot	タネボー		
Pifeuil	コノハナ		
Tengalice	ダーテング		
Nirondelle	スバメ		
Hélédelle	オオスバメ		
Goélise	キャモメ		
Bekipan	ペリッパー	-	
Tarsal	ラルトス		
Kirlia	キルリア		
Gardevoir	サーナイト	-	
Arakdo	アメタマ		
Maskadra	アメモース		
Balignon	キノココ		
Chapignon	キノガッサ		
Parecool	ナマケロ		
Vigoroth	ヤルキモノ		
Monaflèmit	ケッキング		
Ningale	ツチニン	-	
Ninjask	テッカニン	-	
Munja	ヌケニン		
Chuchmur	ゴニョニョ		
Ramboum	ドゴーム		
Brouhabam	バクオング		
Makuhita	マクノシタ		
Hariyama	ハリテヤマ		
Azurill	ルリリ		
Tarinor	ノズパス		
Skitty	エネコ		
Delcatty	エネコロロ		
Ténéfix	ヤミラミ		
Mysdibule	クチート		
Galekid	ココドラ		
Galegon	コドラ		
Galeking	ボスゴドラ	-	
Méditikka	アサナン		
Charmina	チャーレム	-	
Dynavolt	ラクライ		
Élecsprint	ライボルト		
Posipi	プラスル		
Négapi	マイナン		
Muciole	バルビート	-	
Lumivole	イルミーゼ		
Rosélia	ロゼリア		
Gloupti	ゴクリン		
Avaltout	マルノーム		
Carvanha	キバニア		
Sharpedo	サメハダー		
Wailmer	ホエルコ		
Wailord	ホエルオー		
Chamallot	ドンメル		
Camérupt	バクーダ	-	
Chartor	コータス		
Spoink	バネブー		
Groret	ブーピッグ		
Spinda	パッチール		
Kraknoix	ナックラー		
Vibraninf	ビブラーバ		
Libégon	フライゴン		
Cacnea	サボネア		
Cacturne	ノクタス		
Tylton	チルット		
Altaria	チルタリス		
Mangriff	ザングース		
Séviper	ハブネーク		
Séléroc	ルナトーン		
Solaroc	ソルロック		
Barloche	ドジョッチ		
Barbicha	ナマズン		
Écrapince	ヘイガニ		
Colhomard	シザリガー		
Balbuto	ヤジロン		
Kaorine	ネンドール		
Lilia	リリーラ		
Vacilys	ユレイドル	-	
Anorith	アノプス		
Armaldo	アーマルド	-	
Barpau	ヒンバス		
Milobellus	ミロカロス		
Morphéo	ポワルン		
Kecleon	カクレオン		
Polichombr	カゲボウズ		
Branette	ジュペッタ		
Skelénox	ヨマワル		
Téraclope	サマヨール		
Tropius	トロピウス		
Éoko	チリーン		
Absol	アブソル		
Okéoké	ソーナノ	-	
Stalgamin	ユキワラシ		
Oniglali	オニゴーリ		
Obalie	タマザラシ		
Phogleur	トドグラー		
Kaimorse	トドゼルガ	-	
Coquiperl	パールル	-	
Serpang	ハンテール	-	
Rosabyss	サクラビス		
Relicanth	ジーランス		
Lovdisc	ラブカス		
Draby	タツベイ		
Drackhaus	コモルー		
Drattak	ボーマンダ		
Terhal	ダンバル		
Métang	メタング		
Métalosse	メタグロス		
Regirock	レジロック		
Regice	レジアイス		
Registeel	レジスチル		
Latias	ラティアス		
Latios	ラティオス		
Kyogre	カイオーガ		
Groudon	グラードン		
Rayquaza	レックウザ		
Jirachi	ジラーチ	-	
Deoxys	デオキシス	-	
Tortipouss	ナエトル		4
Boskara	ハヤシガメ		
Torterra	ドダイトス		
Ouisticram	ヒコザル		
Chimpenfeu	モウカザル		
Simiabraz	ゴウカザル		
Tiplouf	ポッチャマ		
Prinplouf	ポッタイシ		
Pingoléon	エンペルト		
Étourmi	ムックル		
Étourvol	ムクバード		
Étouraptor	ムクホーク		
Keunotor	ビッパ		
Castorno	ビーダル		
Crikzik	コロボーシ		
Mélokrik	コロトック		
Lixy	コリンク		
Luxio	ルクシオ		
Luxray	レントラー	-	
Rozbouton	スボミー		
Roserade	ロズレイド		
Kranidos	ズガイドス	-	
Charkos	ラムパルド		
Dinoclier	タテトプス		
Bastiodon	トリデプス		
Cheniti	ミノムッチ		
Cheniselle	ミノマダム		
Papilord	ガーメイル	-	
Apitrini	ミツハニー		
Apireine	ビークイン		
Pachirisu	パチリス		
Mustébouée	ブイゼル		
Mustéflott	フローゼル		
Ceribou	チェリンボ	-	
Ceriflor	チェリム		
Sancoki	カラナクシ		
Tritosor	トリトドン		
Capidextre	エテボース		
Baudrive	フワンテ		
Grodrive	フワライド		
Laporeille	ミミロル		
Lockpin	ミミロップ		
Magirêve	ムウマージ		
Corboss	ドンカラス		
Chaglam	ニャルマー		
Chaffreux	ブニャット		
Korillon	リーシャン		
Moufouette	スカンプー		
Moufflair	スカタンク		
Archéomire	ドーミラー		
Archéodong	ドータクン		
Manzaï Jr.	ウソハチ	-	
Mime Jr. 	マネネ	-	
Ptiravi	ピンプク	-	
Pijako	ペラップ	-	
Spiritomb	ミカルゲ		
Griknot	フカマル		
Carmache	ガバイト		
Carchacrok	ガブリアス	-	
Goinfrex	ゴンベ		
Riolu	リオル		
Lucario	ルカリオ		
Hippopotas	ヒポポタス		
Hippodocus	カバルドン		
Rapion	スコルピ		
Drascore	ドラピオン		
Cradopaud	グレッグル		
Coatox	ドクロッグ		
Vortente	マスキッパ		
Écayon	ケイコウオ		
Luminéon	ネオラント		
Babimanta	タマンタ	-	
Blizzi	ユキカブリ		
Blizzaroi	ユキノオー		
Dimoret	マニューラ		
Magnézone	ジバコイル		
Coudlangue	ベロベルト		
Rhinastoc	ドサイドン		
Bouldeneu	モジャンボ		
Élekable	エレキブル		
Maganon	ブーバーン	-	
Togekiss	トゲキッス		
Yanmega	メガヤンマ		
Phyllali	リーフィア		
Givrali	グレイシア		
Scorvol	グライオン		
Mammochon	マンムー		
Porygon-Z	ポリゴンZ		
Gallame	エルレイド		
Tarinorme	ダイノーズ		
Noctunoir	ヨノワール		
Momartik	ユキメノコ		
Motisma	ロトム		
Créhelf	ユクシー		
Créfollet	エムリット		
Créfadet	アグノム		
Dialga	ディアルガ		
Palkia	パルキア		
Heatran	ヒードラン		
Regigigas	レジギガス		
Giratina	ギラティナ		
Cresselia	クレセリア		
Phione	フィオネ		
Manaphy	マナフィ		
Darkrai	ダークライ		
Shaymin	シェイミ		
Arceus	アルセウス		
Victini	ビクティニ		5
Vipélierre	ツタージャ	-	
Lianaja	ジャノビー	-	
Majaspic	ジャローダ	-	
Gruikui	ポカブ	-	
Grotichon	チャオブー		
Roitiflam	エンブオー		
Moustillon	ミジュマル		
Mateloutre	フタチマル	-	
Clamiral	ダイケンキ	-	
Ratentif	ミネズミ		
Miradar	ミルホッグ		
Ponchiot	ヨーテリー		
Ponchien	ハーデリア		
Mastouffe	ムーランド		
Chacripan	チョロネコ		
Léopardus	レパルダス		
Feuillajou	ヤナップ		
Feuiloutan	ヤナッキー		
Flamajou	バオップ		
Flamoutan	バオッキー		
Flotajou	ヒヤップ		
Flotoutan	ヒヤッキー		
Munna	ムンナ		
Mushana	ムシャーナ		
Poichigeon	マメパト	-	
Colombeau	ハトーボー		
Déflaisan	ケンホロウ	-	
Zébibron	シママ		
Zéblitz	ゼブライカ		
Nodulithe	ダンゴロ		
Géolithe	ガントル		
Gigalithe	ギガイアス	-	
Chovsourir	コロモリ		
Rhinolove	ココロモリ	-	
Rototaupe	モグリュー		
Minotaupe	ドリュウズ		
Nanméouïe	タブンネ	-	
Charpenti	ドッコラー	-	
Ouvrifier	ドテッコツ	-	
Bétochef	ローブシン	-	
Tritonde	オタマロ		
Batracné	ガマガル		
Crapustule	ガマゲロゲ		
Judokrak	ナゲキ		
Karaclée	ダゲキ		
Larveyette	クルミル		
Couverdure	クルマユ	-	
Manternel	ハハコモリ		
Venipatte	フシデ		
Scobolide	ホイーガ		
Brutapode	ペンドラー		
Doudouvet	モンメン		
Farfaduvet	エルフーン		
Chlorobule	チュリネ		
Fragilady	ドレディア		
Bargantua	バスラオ		
Mascaïman	メグロコ		
Escroco	ワルビル		
Crocorible	ワルビアル		
Darumarond	ダルマッカ		
Darumacho	ヒヒダルマ		
Maracachi	マラカッチ	-	
Crabicoque	イシズマイ		
Crabaraque	イワパレス	-	
Baggiguane	ズルッグ		
Baggaïd	ズルズキン		
Cryptéro	シンボラー		
Tutafeh	デスマス		
Tutankafer	デスカーン	-	
Carapagos	プロトーガ	-	
Mégapagos	アバゴーラ	-	
Arkéapti	アーケン		
Aéroptéryx	アーケオス		
Miamiasme	ヤブクロン		
Miasmax	ダストダス		
Zorua	ゾロア		
Zoroark	ゾロアーク		
Chinchidou	チラーミィ		
Pashmilla	チラチーノ		
Scrutella	ゴチム		
Mesmérella	ゴチミル		
Sidérella	ゴチルゼル	-	
Nucléososis	ユニラン		
Méios	ダブラン		
Symbios	ランクルス		
Couaneton	コアルヒー		
Lakmécygne	スワンナ	-	
Sorbébé	バニプッチ		
Sorboul	バニリッチ		
Sorbouboul	バイバニラ		
Vivaldaim	シキジカ		
Haydaim	メブキジカ	-	
Emolga	エモンガ		
Carabing	カブルモ		
Lançargot	シュバルゴ	-	
Trompignon	タマゲタケ		
Gaulet	モロバレル	-	
Viskuse	プルリル	-	
Moyade	ブルンゲル	-	
Mamanbo	ママンボウ		
Statitik	バチュル		
Mygavolt	デンチュラ	-	
Grindur	テッシード		
Noacier	ナットレイ	-	
Tic	ギアル		
Clic	ギギアル		
Cliticlic	ギギギアル	-	
Anchwatt	シビシラス		
Lampéroie	シビビール		
Ohmassacre	シビルドン		
Lewsor	リグレー		
Neitram	オーベム		
Funécire	ヒトモシ		
Mélancolux	ランプラー		
Lugulabre	シャンデラ		
Coupenotte	キバゴ		
Incisache	オノンド	-	
Tranchodon	オノノクス		
Polarhume	クマシュン		
Polagriffe	ツンベアー		
Hexagel	フリージオ		
Escargaume	チョボマキ		
Limaspeed	アギルダー		
Limonde	マッギョ		
Kungfouine	コジョフー		
Shaofouine	コジョンド	-	
Drakkarmin	クリムガン		
Gringolem	ゴビット		
Golemastoc	ゴルーグ		
Scalpion	コマタナ		
Scalproie	キリキザン	-	
Frison	バッフロン		
Furaiglon	ワシボン		
Gueriaigle	ウォーグル		
Vostourno	バルチャイ		
Vaututrice	バルジーナ		
Aflamanoir	クイタラン		
Fermite	アイアント	-	
Solochi	モノズ		
Diamat	ジヘッド		
Trioxhydre	サザンドラ		
Pyronille	メラルバ		
Pyrax	ウルガモス		
Cobaltium	コバルオン		
Terrakium	テラキオン		
Viridium	ビリジオン		
Boréas	トルネロス		
Fulguris	ボルトロス		
Reshiram	レシラム	-	
Zekrom	ゼクロム		
Démétéros	ランドロス		
Kyurem	キュレム		
Keldeo	ケルディオ		
Meloetta	メロエッタ		
Genesect	ゲノセクト		
Marisson	ハリマロン	-	6
Boguérisse	ハリボーグ	-	
Blindépique	ブリガロン	-	
Feunnec	フォッコ		
Roussil	テールナー		
Goupelin	マフォクシー	-	
Grenousse	ケロマツ		
Croâporal	ゲコガシラ		
Amphinobi	ゲッコウガ		
Sapereau	ホルビー		
Excavarenne	ホルード		
Passerouge	ヤヤコマ		
Braisillon	ヒノヤコマ		
Flambusard	ファイアロー		
Lépidonille	コフキムシ		
Pérégrain	コフーライ		
Prismillon	ビビヨン		
Hélionceau	シシコ		
Némélios	カエンジシ		
Flabébé	フラベベ		
Floette	フラエッテ		
Florges	フラージェス		
Cabriolaine	メェークル		
Chevroum	ゴーゴート		
Pandespiègle	ヤンチャム		
Pandarbare	ゴロンダ		
Couafarel	トリミアン		
Psystigri	ニャスパー		
Mistigrix	ニャオニクス		
Monorpale	ヒトツキ		
Dimoclès	ニダンギル		
Exagide	ギルガルド		
Fluvetin	シュシュプ		
Cocotine	フレフワン	-	
Sucroquin	ペロッパフ		
Cupcanaille	ペロリーム		
Sepiatop	マーイーカ		
Sepiatroce	カラマネロ		
Opermine	カメテテ		
Golgopathe	ガメノデス		
Venalgue	クズモー		
Kravarech	ドラミドロ		
Flingouste	ウデッポウ		
Gamblast	ブロスター		
Galvaran	エリキテル		
Iguolta	エレザード		
Ptyranidur	チゴラス		
Rexillius	ガチゴラス		
Amagara	アマルス		
Dragmara	アマルルガ	-	
Nymphali	ニンフィア		
Brutalibré	ルチャブル		
Dedenne	デデンネ		
Strassie	メレシー	-	
Mucuscule	ヌメラ		
Colimucus	ヌメイル		
Muplodocus	ヌメルゴン		
Trousselin	クレッフィ		
Brocélôme	ボクレー		
Desséliande	オーロット		
Pitrouille	バケッチャ		
Banshitrouye	パンプジン		
Grelaçon	カチコール		
Séracrawl	クレベース		
Sonistrelle	オンバット		
Bruyverne	オンバーン		
Xerneas	ゼルネアス	-	
Yveltal	イベルタル		
Zygarde	ジガルデ		
Diancie	ディアンシー		
Hoopa	フーパ		
Volcanion	ボルケニオン		
Brindibou	モクロー		7
Efflèche	フクスロー		
Archéduc	ジュナイパー		
Flamiaou	ニャビー		
Matoufeu	ニャヒート		
Félinferno	ガオガエン		
Otaquin	アシマリ		
Otarlette	オシャマリ		
Oratoria	アシレーヌ		
Picassaut	ツツケラ		
Piclairon	ケララッパ		
Bazoucan	ドデカバシ		
Manglouton	ヤングース		
Argouste	デカグース	-	
Larvibule	アゴジムシ		
Chrysapile	デンヂムシ		
Lucanon	クワガノン		
Crabagarre	マケンカニ		
Crabominable	ケケンカニ		
Plumeline	オドリドリ		
Bombydou	アブリー		
Rubombelle	アブリボン		
Rocabot	イワンコ		
Lougaroc	ルガルガン		
Froussardine	ヨワシ		
Vorastérie	ヒドイデ		
Prédastérie	ドヒドイデ	-	
Tiboudet	ドロバンコ		
Bourrinos	バンバドロ	-	
Araqua	シズクモ		
Tarenbulle	オニシズクモ		
Mimantis	カリキリ		
Floramantis	ラランテス		
Spododo	ネマシュ		
Lampignon	マシェード		
Tritox	ヤトウモリ		
Malamandre	エンニュート		
Nounourson	ヌイコグマ		
Chelours	キテルグマ		
Croquine	アマカジ		
Candine	アママイコ		
Sucreine	アマージョ	-	
Guérilande	キュワワー		
Gouroutan	ヤレユータン		
Quartermac	ナゲツケサル		
Sovkipou	コソクムシ		
Sarmuraï	グソクムシャ		
Bacabouh	スナバァ		
Trépassable	シロデスナ		
Concombaffe	ナマコブシ		
Type:0	タイプ：ヌル		
Silvallié	シルヴァディ	-	
Météno	メテノ	-	
Dodoala	ネッコアラ		
Boumata	バクガメス		
Togedemaru	トゲデマル		
Mimiqui	ミミッキュ		
Denticrisse	ハギギシリ		
Draïeul	ジジーロン		
Sinistrail	ダダリン		
Bébécaille	ジャラコ		
Écaïd	ジャランゴ		
Ékaïser	ジャラランガ		
Tokorico	カプ・コケコ		
Tokopiyon	カプ・テテフ		
Tokotoro	カプ・ブルル		
Tokopisco	カプ・レヒレ		
Cosmog	コスモッグ		
Cosmovum	コスモウム		
Solgaleo	ソルガレオ		
Lunala	ルナアーラ		
Zéroïd	ウツロイド	-	
Mouscoto	マッシブーン		
Cancrelove	フェローチェ		
Câblifère	デンジュモク		
Bamboiselle	テッカグヤ	-	
Katagami	カミツルギ		
Engloutyran	アクジキング		
Necrozma	ネクロズマ		
Magearna	マギアナ	-	
Marshadow	マーシャドー		
Vémini	ベベノム		
Mandrillon	アーゴヨン		
Ama-Ama	ツンデツンデ		
Pierroteknik	ズガドーン		
Zeraora	ゼラオラ		
Meltan	メルタン		
Melmetal	メルメタル		
Ouistempo	サルノリ		8
Badabouin	バチンキー		
Gorythmic	ゴリランダー		
Flambino	ヒバニー	-	
Lapyro	ラビフット	-	
Pyrobut	エースバーン	-	
Larméléon	メッソン	-	
Arrozard	ジメレオン	-	
Lézargus	インテレオン	-	
Rongourmand	ホシガリス	-	
Rongrigou	ヨクバリス	-	
Minisange	ココガラ	-	
Bleuseille	アオガラス	-	
Corvaillus	アーマーガア	-	
Larvadar	サッチムシ		
Coléodôme	レドームシ	-	
Astronelle	イオルブ	-	
Goupilou	クスネ		
Roublenard	フォクスライ		
Tournicoton	ヒメンカ		
Blancoton	ワタシラガ		
Moumouton	ウールー	-	
Moumouflon	バイウールー	-	
Khélocrok	カムカメ		
Torgamord	カジリガメ	-	
Voltoutou	ワンパチ	-	
Fulgudog	パルスワン	-	
Charbi	タンドン	-	
Wagomine	トロッゴン	-	
Monthracite	セキタンザン	-	
Verpom	カジッチュ		
Pomdrapi	アップリュー		
Dratatin	タルップル		
Dunaja	スナヘビ	-	
Dunaconda	サダイジャ	-	
Nigosier	ウッウ		
Embrochet	サシカマス		
Hastacuda	カマスジョー	-	
Toxizap	エレズン	-	
Salarsen	ストリンダー		
Grillepattes	ヤクデ		
Scolocendre	マルヤクデ		
Poulpaf	タタッコ	-	
Krakos	オトスパス		
Théffroi	ヤバチャ		
Polthégeist	ポットデス		
Bibichut	ミブリム		
Chapotus	テブリム		
Sorcilence	ブリムオン	-	
Grimalin	ベロバー	-	
Fourbelin	ギモー	-	
Angoliath	オーロンゲ	-	
Ixon	タチフサグマ	-	
Berserkatt	ニャイキング	-	
Corayôme	サニゴーン	-	
Palarticho	ネギガナイト	-	
M. Glaquette 	バリコオル	-	
Tutétékri	デスバーン	-	
Crèmy	マホミル		
Charmilly	マホイップ		
Hexadron	タイレーツ	-	
Wattapik	バチンウニ	-	
Frissonille	ユキハミ		
Beldeneige	モスノウ		
Dolman	イシヘンジン	-	
Bekaglaçon	コオリッポ		
Wimessir	イエッサン	-	
Morpeko	モルペコ		
Charibari	ゾウドウ		
Pachyradjah	ダイオウドウ	-	
Galvagon	パッチラゴン	-	
Galvagla	パッチルドン	-	
Hydragon	ウオノラゴン		
Hydragla	ウオチルドン	-	
Duralugon	ジュラルドン	-	
Fantyrm	ドラメシヤ		
Dispareptil	ドロンチ		
Lanssorien	ドラパルト		
Zacian	ザシアン	-	
Zamazenta	ザマゼンタ	-	
Éthernatos	ムゲンダイナ	-	
Wushours	ダクマ	-	
Shifours	ウーラオス		
Zarude	ザルード	-	
Regieleki	レジエレキ	-	
Regidrago	レジドラゴ	-	
Blizzeval	ブリザポス		
Spectreval	レイスポス	-	
Sylveroy	バドレックス	-	
Cerbyllin	アヤシシ	-	
Hachécateur	バサギリ	-	
Ursaking	ガチグマ	-	
Paragruel	イダイトウ	-	
Farfurex	オオニューラ	-	
Qwilpik	ハリーマン		
Amovénus	ラブトロス	-	
Poussacha	ニャオハ	-	9
Matourgeon	ニャローテ	-	
Miascarade	マスカーニャ	-	
Chochodile	ホゲータ	-	
Crocogril	アチゲータ	-	
Flâmigator	ラウドボーン	-	
Coiffeton	クワッス	-	
Canarbello	ウェルカモ	-	
Palmaval	ウェーニバル	-	
Gourmelet	グルトン	-	
Fragroin	パフュートン	-	
Tissenboule	タマンチュラ		
Filentrappe	ワナイダー	-	
Lilliterelle	マメバッタ	-	
Gambex	エクスレッグ	-	
Pohm	パモ	-	
Pohmotte	パモット	-	
Pohmarmotte	パーモット	-	
Compagnol	ワッカネズミ		
Famignol	イッカネズミ		
Pâtachiot	パピモッチ	-	
Briochien	バウッツェル	-	
Olivini	ミニーブ	-	
Olivado	オリーニョ	-	
Arboliva	オリーヴァ	-	
Tapatoès	イキリンコ	-	
Selutin	コジオ	-	
Amassel	ジオヅム	-	
Gigansel	キョジオーン	-	
Charbambin	カルボウ	-	
Carmadura	グレンアルマ	-	
Malvalame	ソウブレイズ	-	
Têtampoule	ズピカ	-	
Ampibidou	ハラバリー	-	
Zapétrel	カイデン	-	
Fulgulairo	タイカイデン	-	
Grondogue	オラチフ	-	
Dogrino	マフィティフ	-	
Gribouraigne	シルシュルー	-	
Tag-Tag	タギングル	-	
Virovent	アノクサ	-	
Virevorreur	アノホラグサ	-	
Terracool	ノノクラゲ	-	
Terracruel	リククラゲ	-	
Craparoi	ガケガニ	-	
Pimito	カプサイジ	-	
Scovilain	スコヴィラン	-	
Léboulérou	シガロコ	-	
Bérasca	ベラカス	-	
Flotillon	ヒラヒナ	-	
Cléopsytra	クエスパトラ	-	
Forgerette	カヌチャン	-	
Forgella	ナカヌチャン	-	
Forgelina	デカヌチャン	-	
Taupikeau	ウミディグダ	-	
Triopikeau	ウミトリオ	-	
Lestombaile	オトシドリ	-	
Dofin	ナミイルカ	-	
Superdofin	イルカマン	-	
Vrombi	ブロロン	-	
Vrombotor	ブロロローム	-	
Motorizard	モトトカゲ		
Ferdeter	ミミズズ	-	
Germéclat	キラーメ	-	
Floréclat	キラフロル	-	
Toutombe	ボチ		
Tomberro	ハカドッグ	-	
Flamenroule	カラミンゴ	-	
Piétacé	アルクジラ	-	
Balbalèze	ハルクジラ	-	
Délestin	ミガルーサ	-	
Oyacata	ヘイラッシャ	-	
Nigirigon	シャリタツ	-	
Courrousinge	コノヨザル	-	
Terraiste	ドオー	-	
Farigiraf	リキキリン	-	
Deusolourdo	ノココッチ	-	
Scalpereur	ドドゲザン	-	
Fort-Ivoire	イダイナキバ	-	
Hurle-Queue	サケブシッポ	-	
Fongus-Furie	アラブルタケ	-	
Flotte-Mèche	ハバタクカミ	-	
Rampe-Ailes	チヲハウハネ	-	
Pelage-Sablé	スナノケガワ	-	
Roue-de-Fer	テツノワダチ	-	
Hotte-de-Fer	テツノツツミ	-	
Paume-de-Fer	テツノカイナ	-	
Têtes-de-Fer	テツノコウベ	-	
Mite-de-Fer	テツノドクガ	-	
Épine-de-Fer	テツノイバラ	-	
Frigodo	セビエ		
Cryodo	セゴール	-	
Glaivodo	セグレイブ	-	
Mordudor	コレクレー	-	
Gromago	サーフゴー	-	
Chongjian	チオンジェン	-	
Baojian	パオジアン	-	
Dinglu	ディンルー	-	
Yuyu	イーユイ	-	
Rugit-Lune	トドロクツキ	-	
Garde-de-Fer	テツノブジン	-	
Koraidon	コライドン	-	
Miraidon	ミライドン	-	
Serpente-Eau	ウネルミナモ	-	
Vert-de-Fer	テツノイサハ	-	
Pomdramour	カミッチュ	-	
Poltchageist	チャデス		
Théffroyable	ヤバソチャ	-	
Félicanis	イイネイヌ	-	
Fortusimia	マシマシラ	-	
Favianos	キチキギス	-	
Ogerpon	オーガポン	-	
Pondralugon	ブリジュラス	-	
Pomdorochi	カミツオロチ	-	
Feu-Perçant	ウガツホムラ	-	
Ire-Foudre	タケルライコ	-	
Roc-de-Fer	テツノイワオ	-	
Chef-de-Fer	テツノカシラ	-	
Terapagos	テラパゴス	-	
Pêchaminus	モモワロウ	-	